1111111111111
10110000C0001
1C00011111001
1P0011E00C001
1111111111111
